中国	中国
美国	美国
英国	英国
日本	日本
新加坡	新加坡
澳大利亚	澳大利亚
香港特别行政区	香港
韩国	韩国
德国	德国
印度	印度
法国	法国
菲律宾	菲律宾
加拿大	加拿大
爱尔兰	爱尔兰
印度尼西亚	印度尼西亚
西班牙	西班牙
马来西亚	马来西亚
新西兰	新西兰
欧洲	欧洲
越南	越南
瑞士	瑞士
荷兰	荷兰
巴基斯坦	巴基斯坦
澳门特别行政区	澳门
南非	南非
挪威	挪威
秘鲁	秘鲁
意大利	意大利
瑞典	瑞典
冰岛	冰岛
俄罗斯	俄罗斯
塔吉克斯坦	塔吉克斯坦
墨西哥	墨西哥
泰国	泰国
阿联酋	阿联酋
卢森堡	卢森堡
科威特	科威特
沙特阿拉伯	沙特阿拉伯
丹麦	丹麦
芬兰	芬兰
以色列	以色列
巴林	巴林
比利时	比利时
台湾省	台湾
洪都拉斯	洪都拉斯
尼日利亚	尼日利亚
哈萨克斯坦共和国	哈萨克斯坦共和国
毛里求斯	毛里求斯
埃及	埃及
埃塞俄比亚	埃塞俄比亚
加纳	加纳
巴西	巴西
匈牙利	匈牙利
奥地利	奥地利
赞比亚	赞比亚
文莱	文莱
贝宁共和国	贝宁共和国
肯尼亚	肯尼亚
卡塔尔	卡塔尔
葡萄牙	葡萄牙
阿根廷	阿根廷
刚果	刚果
保加利亚	保加利亚
智利	智利
蒙古	蒙古
波兰	波兰
阿曼苏丹国	阿曼苏丹国
马达加斯加	马达加斯加
北京市	北京
上海市	上海
天津市	天津
黑龙江省	黑龙江
湖北省	湖北
湖南省	湖南
江西省	江西
山西省	山西
重庆市	重庆
安徽省	安徽
江苏省	江苏
浙江省	浙江
吉林省	吉林
辽宁省	辽宁
山东省	山东
河南省	河南
福建省	福建
陕西省	陕西
新疆维吾尔自治区	新疆
内蒙古自治区	内蒙古
广西壮族自治区	广西
云南省	云南
广东省	广东
河北省	河北
四川省	四川
海南省	海南
贵州省	贵州
宁夏回族自治区	宁夏
甘肃省	甘肃
青海省	青海
西藏自治区	西藏
东城区	北京-东城区
西城区	北京-西城区
朝阳区	北京-朝阳区
丰台区	北京-丰台区
石景山区	北京-石景山区
海淀区	北京-海淀区
门头沟区	北京-门头沟区
房山区	北京-房山区
通州区	北京-通州区
顺义区	北京-顺义区
昌平区	北京-昌平区
大兴区	北京-大兴区
怀柔区	北京-怀柔区
平谷区	北京-平谷区
密云区	北京-密云县
延庆区	北京-延庆县
和平区	天津-和平区
河东区	天津-河东区
河西区	天津-河西区
南开区	天津-南开区
河北区	天津-河北区
红桥区	天津-红桥区
东丽区	天津-东丽区
西青区	天津-西青区
津南区	天津-津南区
北辰区	天津-北辰区
武清区	天津-武清区
宝坻区	天津-宝坻区
滨海新区	天津-滨海新区
宁河区	天津-宁河县
静海区	天津-静海县
蓟州区	天津-蓟县
石家庄市	河北-石家庄市
唐山市	河北-唐山市
秦皇岛市	河北-秦皇岛市
邯郸市	河北-邯郸市
邢台市	河北-邢台市
保定市	河北-保定市
张家口市	河北-张家口市
承德市	河北-承德市
沧州市	河北-沧州市
廊坊市	河北-廊坊市
衡水市	河北-衡水市
太原市	山西-太原市
大同市	山西-大同市
阳泉市	山西-阳泉市
长治市	山西-长治市
晋城市	山西-晋城市
朔州市	山西-朔州市
晋中市	山西-晋中市
运城市	山西-运城市
忻州市	山西-忻州市
临汾市	山西-临汾市
吕梁市	山西-吕梁市
呼和浩特市	内蒙古-呼和浩特市
包头市	内蒙古-包头市
乌海市	内蒙古-乌海市
赤峰市	内蒙古-赤峰市
通辽市	内蒙古-通辽市
鄂尔多斯市	内蒙古-鄂尔多斯市
呼伦贝尔市	内蒙古-呼伦贝尔市
巴彦淖尔市	内蒙古-巴彦淖尔市
乌兰察布市	内蒙古-乌兰察布市
兴安盟	内蒙古-兴安盟
锡林郭勒盟	内蒙古-锡林郭勒盟
阿拉善盟	内蒙古-阿拉善盟
沈阳市	辽宁-沈阳市
大连市	辽宁-大连市
鞍山市	辽宁-鞍山市
抚顺市	辽宁-抚顺市
本溪市	辽宁-本溪市
丹东市	辽宁-丹东市
锦州市	辽宁-锦州市
营口市	辽宁-营口市
阜新市	辽宁-阜新市
辽阳市	辽宁-辽阳市
盘锦市	辽宁-盘锦市
铁岭市	辽宁-铁岭市
朝阳市	辽宁-朝阳市
葫芦岛市	辽宁-葫芦岛市
长春市	吉林-长春市
吉林市	吉林-吉林市
四平市	吉林-四平市
辽源市	吉林-辽源市
通化市	吉林-通化市
白山市	吉林-白山市
松原市	吉林-松原市
白城市	吉林-白城市
延边朝鲜族自治州	吉林-延边朝鲜族自治州
哈尔滨市	黑龙江-哈尔滨市
齐齐哈尔市	黑龙江-齐齐哈尔市
鸡西市	黑龙江-鸡西市
鹤岗市	黑龙江-鹤岗市
双鸭山市	黑龙江-双鸭山市
大庆市	黑龙江-大庆市
伊春市	黑龙江-伊春市
佳木斯市	黑龙江-佳木斯市
七台河市	黑龙江-七台河市
牡丹江市	黑龙江-牡丹江市
黑河市	黑龙江-黑河市
绥化市	黑龙江-绥化市
大兴安岭地区	黑龙江-大兴安岭地区
黄浦区	上海-黄浦区
徐汇区	上海-徐汇区
长宁区	上海-长宁区
静安区	上海-静安区
普陀区	上海-普陀区
虹口区	上海-虹口区
杨浦区	上海-杨浦区
闵行区	上海-闵行区
宝山区	上海-宝山区
嘉定区	上海-嘉定区
浦东新区	上海-浦东新区
金山区	上海-金山区
松江区	上海-松江区
青浦区	上海-青浦区
奉贤区	上海-奉贤区
崇明区	上海-崇明区
南京市	江苏-南京市
无锡市	江苏-无锡市
徐州市	江苏-徐州市
常州市	江苏-常州市
苏州市	江苏-苏州市
南通市	江苏-南通市
连云港市	江苏-连云港市
淮安市	江苏-淮安市
盐城市	江苏-盐城市
扬州市	江苏-扬州市
镇江市	江苏-镇江市
泰州市	江苏-泰州市
宿迁市	江苏-宿迁市
杭州市	浙江-杭州市
宁波市	浙江-宁波市
温州市	浙江-温州市
嘉兴市	浙江-嘉兴市
湖州市	浙江-湖州市
绍兴市	浙江-绍兴市
金华市	浙江-金华市
衢州市	浙江-衢州市
舟山市	浙江-舟山市
台州市	浙江-台州市
丽水市	浙江-丽水市
合肥市	安徽-合肥市
芜湖市	安徽-芜湖市
蚌埠市	安徽-蚌埠市
淮南市	安徽-淮南市
马鞍山市	安徽-马鞍山市
淮北市	安徽-淮北市
铜陵市	安徽-铜陵市
安庆市	安徽-安庆市
黄山市	安徽-黄山市
滁州市	安徽-滁州市
阜阳市	安徽-阜阳市
宿州市	安徽-宿州市
巢湖市	安徽-巢湖市
六安市	安徽-六安市
亳州市	安徽-亳州市
池州市	安徽-池州市
宣城市	安徽-宣城市
福州市	福建-福州市
厦门市	福建-厦门市
莆田市	福建-莆田市
三明市	福建-三明市
泉州市	福建-泉州市
漳州市	福建-漳州市
南平市	福建-南平市
龙岩市	福建-龙岩市
宁德市	福建-宁德市
南昌市	江西-南昌市
景德镇市	江西-景德镇市
萍乡市	江西-萍乡市
九江市	江西-九江市
新余市	江西-新余市
鹰潭市	江西-鹰潭市
赣州市	江西-赣州市
吉安市	江西-吉安市
宜春市	江西-宜春市
抚州市	江西-抚州市
上饶市	江西-上饶市
济南市	山东-济南市
青岛市	山东-青岛市
淄博市	山东-淄博市
枣庄市	山东-枣庄市
东营市	山东-东营市
烟台市	山东-烟台市
潍坊市	山东-潍坊市
济宁市	山东-济宁市
泰安市	山东-泰安市
威海市	山东-威海市
日照市	山东-日照市
莱芜市	山东-莱芜市
临沂市	山东-临沂市
德州市	山东-德州市
聊城市	山东-聊城市
滨州市	山东-滨州市
菏泽市	山东-菏泽市
郑州市	河南-郑州市
开封市	河南-开封市
洛阳市	河南-洛阳市
平顶山市	河南-平顶山市
安阳市	河南-安阳市
鹤壁市	河南-鹤壁市
新乡市	河南-新乡市
焦作市	河南-焦作市
濮阳市	河南-濮阳市
许昌市	河南-许昌市
漯河市	河南-漯河市
三门峡市	河南-三门峡市
南阳市	河南-南阳市
商丘市	河南-商丘市
信阳市	河南-信阳市
周口市	河南-周口市
驻马店市	河南-驻马店市
武汉市	湖北-武汉市
黄石市	湖北-黄石市
十堰市	湖北-十堰市
宜昌市	湖北-宜昌市
襄阳市	湖北-襄阳市
鄂州市	湖北-鄂州市
荆门市	湖北-荆门市
孝感市	湖北-孝感市
荆州市	湖北-荆州市
黄冈市	湖北-黄冈市
咸宁市	湖北-咸宁市
随州市	湖北-随州市
恩施土家族苗族自治州	湖北-恩施土家族苗族自治州
长沙市	湖南-长沙市
株洲市	湖南-株洲市
湘潭市	湖南-湘潭市
衡阳市	湖南-衡阳市
邵阳市	湖南-邵阳市
岳阳市	湖南-岳阳市
常德市	湖南-常德市
张家界市	湖南-张家界市
益阳市	湖南-益阳市
郴州市	湖南-郴州市
永州市	湖南-永州市
怀化市	湖南-怀化市
娄底市	湖南-娄底市
湘西土家族苗族自治州	湖南-湘西土家族苗族自治州
广州市	广东-广州市
韶关市	广东-韶关市
深圳市	广东-深圳市
珠海市	广东-珠海市
汕头市	广东-汕头市
佛山市	广东-佛山市
江门市	广东-江门市
湛江市	广东-湛江市
茂名市	广东-茂名市
肇庆市	广东-肇庆市
惠州市	广东-惠州市
梅州市	广东-梅州市
汕尾市	广东-汕尾市
河源市	广东-河源市
阳江市	广东-阳江市
清远市	广东-清远市
东莞市	广东-东莞市
中山市	广东-中山市
潮州市	广东-潮州市
揭阳市	广东-揭阳市
云浮市	广东-云浮市
南宁市	广西-南宁市
柳州市	广西-柳州市
桂林市	广西-桂林市
梧州市	广西-梧州市
北海市	广西-北海市
防城港市	广西-防城港市
钦州市	广西-钦州市
贵港市	广西-贵港市
玉林市	广西-玉林市
百色市	广西-百色市
贺州市	广西-贺州市
河池市	广西-河池市
来宾市	广西-来宾市
崇左市	广西-崇左市
海口市	海南-海口市
三亚市	海南-三亚市
万州区	重庆-万州区
涪陵区	重庆-涪陵区
渝中区	重庆-渝中区
大渡口区	重庆-大渡口区
江北区	重庆-江北区
沙坪坝区	重庆-沙坪坝区
九龙坡区	重庆-九龙坡区
南岸区	重庆-南岸区
北碚区	重庆-北碚区
渝北区	重庆-渝北区
巴南区	重庆-巴南区
黔江区	重庆-黔江区
长寿区	重庆-长寿区
江津区	重庆-江津区
合川区	重庆-合川区
永川区	重庆-永川区
南川区	重庆-南川区
綦江区	重庆-綦江县
潼南区	重庆-潼南县
铜梁区	重庆-铜梁县
大足区	重庆-大足县
荣昌区	重庆-荣昌县
璧山区	重庆-璧山县
梁平区	重庆-梁平县
城口县	重庆-城口县
丰都县	重庆-丰都县
垫江县	重庆-垫江县
武隆区	重庆-武隆区
忠县	重庆-忠县
开州区	重庆-开县
云阳县	重庆-云阳县
奉节县	重庆-奉节县
巫山县	重庆-巫山县
巫溪县	重庆-巫溪县
石柱土家族自治县	重庆-石柱土家族自治县
秀山土家族苗族自治县	重庆-秀山土家族苗族自治县
酉阳土家族苗族自治县	重庆-酉阳土家族苗族自治县
彭水苗族土家族自治县	重庆-彭水苗族土家族自治县
成都市	四川-成都市
自贡市	四川-自贡市
攀枝花市	四川-攀枝花市
泸州市	四川-泸州市
德阳市	四川-德阳市
绵阳市	四川-绵阳市
广元市	四川-广元市
遂宁市	四川-遂宁市
内江市	四川-内江市
乐山市	四川-乐山市
南充市	四川-南充市
眉山市	四川-眉山市
宜宾市	四川-宜宾市
广安市	四川-广安市
达州市	四川-达州市
雅安市	四川-雅安市
巴中市	四川-巴中市
资阳市	四川-资阳市
阿坝藏族羌族自治州	四川-阿坝藏族羌族自治州
甘孜藏族自治州	四川-甘孜藏族自治州
凉山彝族自治州	四川-凉山彝族自治州
贵阳市	贵州-贵阳市
六盘水市	贵州-六盘水市
遵义市	贵州-遵义市
安顺市	贵州-安顺市
铜仁市	贵州-铜仁地区
黔西南布依族苗族自治州	贵州-黔西南布依族苗族自治州
毕节市	贵州-毕节地区
黔东南苗族侗族自治州	贵州-黔东南苗族侗族自治州
黔南布依族苗族自治州	贵州-黔南布依族苗族自治州
昆明市	云南-昆明市
曲靖市	云南-曲靖市
玉溪市	云南-玉溪市
保山市	云南-保山市
昭通市	云南-昭通市
丽江市	云南-丽江市
普洱市	云南-普洱市
临沧市	云南-临沧市
楚雄彝族自治州	云南-楚雄彝族自治州
红河哈尼族彝族自治州	云南-红河哈尼族彝族自治州
文山壮族苗族自治州	云南-文山壮族苗族自治州
西双版纳傣族自治州	云南-西双版纳傣族自治州
大理白族自治州	云南-大理白族自治州
德宏傣族景颇族自治州	云南-德宏傣族景颇族自治州
怒江傈僳族自治州	云南-怒江傈僳族自治州
迪庆藏族自治州	云南-迪庆藏族自治州
拉萨市	西藏-拉萨市
昌都市	西藏-昌都地区
山南市	西藏-山南地区
日喀则市	西藏-日喀则地区
那曲市	西藏-那曲地区
阿里地区	西藏-阿里地区
林芝市	西藏-林芝地区
西安市	陕西-西安市
铜川市	陕西-铜川市
宝鸡市	陕西-宝鸡市
咸阳市	陕西-咸阳市
渭南市	陕西-渭南市
延安市	陕西-延安市
汉中市	陕西-汉中市
榆林市	陕西-榆林市
安康市	陕西-安康市
商洛市	陕西-商洛市
兰州市	甘肃-兰州市
嘉峪关市	甘肃-嘉峪关市
金昌市	甘肃-金昌市
白银市	甘肃-白银市
天水市	甘肃-天水市
武威市	甘肃-武威市
张掖市	甘肃-张掖市
平凉市	甘肃-平凉市
酒泉市	甘肃-酒泉市
庆阳市	甘肃-庆阳市
定西市	甘肃-定西市
陇南市	甘肃-陇南市
临夏回族自治州	甘肃-临夏回族自治州
甘南藏族自治州	甘肃-甘南藏族自治州
西宁市	青海-西宁市
海东市	青海-海东地区
海北藏族自治州	青海-海北藏族自治州
黄南藏族自治州	青海-黄南藏族自治州
海南藏族自治州	青海-海南藏族自治州
果洛藏族自治州	青海-果洛藏族自治州
玉树藏族自治州	青海-玉树藏族自治州
海西蒙古族藏族自治州	青海-海西蒙古族藏族自治州
银川市	宁夏-银川市
石嘴山市	宁夏-石嘴山市
吴忠市	宁夏-吴忠市
固原市	宁夏-固原市
中卫市	宁夏-中卫市
乌鲁木齐市	新疆-乌鲁木齐市
克拉玛依市	新疆-克拉玛依市
吐鲁番市	新疆-吐鲁番地区
哈密市	新疆-哈密地区
昌吉回族自治州	新疆-昌吉回族自治州
博尔塔拉蒙古自治州	新疆-博尔塔拉蒙古自治州
巴音郭楞蒙古自治州	新疆-巴音郭楞蒙古自治州
阿克苏地区	新疆-阿克苏地区
克孜勒苏柯尔克孜自治州	新疆-克孜勒苏柯尔克孜自治州
喀什地区	新疆-喀什地区
和田地区	新疆-和田地区
伊犁哈萨克自治州	新疆-伊犁哈萨克自治州
塔城地区	新疆-塔城地区
阿勒泰地区	新疆-阿勒泰地区
安哥拉	安哥拉
孟加拉	孟加拉
捷克	捷克
仙桃市	湖北-仙桃市
老挝	老挝
两江新区	重庆-两江新区
吉尔吉斯斯坦	吉尔吉斯斯坦
文昌市	海南-文昌市
斯里兰卡	斯里兰卡
喀麦隆	喀麦隆
柬埔寨	柬埔寨
萨摩亚	萨摩亚
巴布亚新几内亚	巴布亚新几内亚
琼海市	海南-琼海市
希腊	希腊
博茨瓦纳	博茨瓦纳
乌克兰	乌克兰
厄立特里亚	厄立特里亚
巴拿马	巴拿马
约旦	约旦
委内瑞拉	委内瑞拉
纳米比亚	纳米比亚
阿图什市	新疆-阿图什市
圭亚那	圭亚那
临高县	海南-临高县
加蓬共和国	加蓬共和国
格鲁吉亚	格鲁吉亚
哥伦比亚	哥伦比亚
石河子市	新疆-石河子市
坦桑尼亚	坦桑尼亚
乌拉圭	乌拉圭
多哥	多哥
澄迈县	海南-澄迈县
玻利维亚	玻利维亚
克罗地亚	克罗地亚
格尔木市	青海-格尔木
塞浦路斯	塞浦路斯
吉布提	吉布提
瓦努阿图	瓦努阿图
塞舌尔	塞舌尔
不丹	不丹
突尼西亚	突尼西亚
尼泊尔	尼泊尔
塞拉利昂	塞拉利昂
巴巴多斯	巴巴多斯
潜江市	湖北-潜江市
苏里南共和国	苏里南共和国
缅甸	缅甸
土耳其	土耳其
加蓬共和国	加蓬共和国
张家港市	江苏-张家港市
乌干达	乌干达
爱沙尼亚共和国	爱沙尼亚共和国
儋州市	海南-儋州市
斐济共和国	斐济共和国
马绍尔群岛共和国	马绍尔群岛共和国
马耳他共和国	马耳他共和国
汝州市	河南-汝州市
乌兹别克斯坦	乌兹别克斯坦
罗马尼亚	罗马尼亚
塞内加尔	塞内加尔
伊拉克	伊拉克
斯洛文尼亚	斯洛文尼亚
斯洛伐克共和国	斯洛伐克共和国
古巴	古巴
国外	国外
三沙市	海南-三沙市
未披露	未披露
未披露	未披露
未披露	云南-未披露
未披露	内蒙古-未披露
未披露	北京-未披露
未披露	吉林-未披露
未披露	四川-未披露
未披露	天津-未披露
未披露	宁夏-未披露
未披露	安徽-未披露
未披露	山东-未披露
未披露	山西-未披露
未披露	广东-未披露
未披露	广西-未披露
未披露	新疆-未披露
未披露	江苏-未披露
未披露	江西-未披露
未披露	河北-未披露
未披露	河南-未披露
未披露	浙江-未披露
未披露	海南-未披露
未披露	湖北-未披露
未披露	湖南-未披露
未披露	甘肃-未披露
未披露	福建-未披露
未披露	西藏-未披露
未披露	贵州-未披露
未披露	辽宁-未披露
未披露	重庆-未披露
未披露	陕西-未披露
未披露	青海-未披露
未披露	黑龙江-未披露
未披露	上海-未披露
列支敦士登	列支敦士登
英属维尔京群岛	英属维尔京群岛
开曼群岛	开曼群岛
纽埃岛	纽埃岛
巴哈马群岛	巴哈马群岛
百慕大群岛	百慕大群岛
